(######)
<......>
<......>
< ....x>
<......>
<..x...>
[------]
{######}
