(######)
<......>
< .....>
<x....x>
<......>
<.. ...>
[------]
{######}
