(######)
<..  ..>
<......>
<x....x>
<......>
<..  ..>
[------]
{######}
