(######)
< .....>
< .....>
< ....Q>
< .....>
< .....>
[------]
{######}
