(######)
<..x...>
<..... >
<x.....>
<......>
<..x...>
[------]
{######}
