(######)
<..x...>
<......>
<.....x>
<......>
< .x...>
[------]
{######}
