(######)
<..x...>
<......>
<.....x>
<......>
< .... >
[------]
{######}
