(######)
<  ....>
<......>
<x.....>
<......>
<......>
[------]
{######}
