(######)
<......>
<. ....>
<x.....>
<......>
<..x...>
[------]
{######}
