(######)
<. .. .>
<......>
<x....x>
<......>
<......>
[------]
{######}
