(######)
<......>
<......>
<x....x>
<......>
< .....>
[------]
{######}
