(######)
<.. ...>
< .....>
<.....x>
<......>
<..x...>
[------]
{######}
