(######)
< .....>
<......>
<x....x>
<......>
<. ....>
[------]
{######}
