111111111111111
1P0000000000001
101CC10S1111001
101CC100CCCC101
100111S01111S01
1S0S01001CCCC01
1000010S0111101
100S000000000E1
111111111111111