111111111111111
1P0000000000001
101CC1001111001
101CC100CCCC101
100111001111001
100001001CCCC01
100001000111101
1000000000000E1
111111111111111