1111111111111
10010000000C1
1000011111S01
1P0011E0S0001
10S0000000001
1111111111111