1111111111111111111111111111111111
1E000000S000000C00000C00S000000001
1010S10100100000101001000000010101
10100100101010100010010000000101S1
1P000S000C00C0000000000S00000000C1
100S000000000000000S00000000S00001
1111111111111111111111111111111111